badminton	selected
bed	selected
bye	selected
car	selected
computer	selected
computer science	selected
factory	selected
frigde	selected
gorgeous	selected
hello	selected
indicate	selected
information technology	selected
merit	selected
morning	selected
phone	selected
raincoat	ao mua
shoes	doi giay
soccer	bong da
sweat	ngọt
table tennis	bong ban
ugly	xấu
